XXXXXXXXXXXXXXXXXXXXXXXXXXXXXXXXXXXXXXXXXXXXXX
XXXXXXXXXXXXXXXXXXXXXXXXXXXXXXXXXXXXXXXXXXXXXX
XXXXXXXXXXXXXXXLLLLLLLLXXXXXXXXXXXXXXXXXXXXXXX
XXXXXXXXXXXXXXLLXLLLLLLLLLLLLLLXXXXXXXXXXXXXXX
XXXXXXXXXXXXXXLLLLLLLLLLLLLLLLLLLXXXXXXXXXXXXX
XXXXXXXXXXXXXXXLLLLLLLLXXXXXXXLLLLLXXXXXXXXXXX
XXXXXXXXXXXXXXXXXXXXXLLXXXXXXXXXLLLLLXXXXXXXXX
XXXXXXXXXXXXXXXXXXXXXLLXXXXXXXXXXXLLLXXXXXXXXX
XXXXXXXXLXLXXXXXXXXXXLLXXXXXXXXXXXXLLLXXXXXXXX
XXLLXLLLLLLXXXXXXXXXXLLXXXXXXXXXXXXLLLXXXXXXXX
XXLLLLLLLLLXXXXXXXXXLLLLXXXXXXXXXXXLLLXXXXXXXX
XXLLLLXXLLLXXXXXXXXLLLLLLLLXXXXXXXXLLLXXXXXXXX
XXXXXXXXLLLXXXXXXXXLLLLLLLLXXXXXXXXLLLXXLXXLXX
XXXXXXXXLLLXXXXXXXXXLLLLLLXXXXXXXXXLLLLLLLLLXX
XXXXXXXXLLLXXXXXXXXXXXXLLXXXXXXXXXXLLLLLLLLLXX
XXXXXXXXLLLXXXXXXXXXXXXLLXXXXXXXXXXLLLXXLLLLXX
XXXXXXXXLLLLLXXXXXXXXXXLLXXXXXXXXXXXXXXXXXXXXX
XXXXXXXXXLLLLXXXXXXXXXXLLXXXXXXXXXXXXXXXXXXXXX
XXXXXXXXXXLLLLXXXXXXXXLLLLLLLLXXXXXXXXXXXXXXXX
XXXXXXXXXXXXLLLLLLLLLLLLLLLLLLLXXXXXXXXXXXXXXX
XXXXXXXXXXXXXXLLLLLLLLLLLLLLLLLXXXXXXXXXXXXXXX
XXXXXXXXXXXXXXXXXXXXXXLLLLLLLLXXXXXXXXXXXXXXXX
XXXXXXXXXXXXXXXXXXXXXXXXXXXXXXXXXXXXXXXXXXXXXX
XXXXXXXXXXXXXXXXXXXXXXXXXXXXXXXXXXXXXXXXXXXXXX