XXXXXXXXXXXXXXXXXXXXXXXXXXXXXXXXXXXXXXXXXXXXXX
XXXXXXXXXXXXXXXXXXXXXXXXXXXXXXXXXXXXXXXXXXXXXX
XXXXXXXXXXXXXXXXLLLLLLLLXXXXXXXXXXXXXXXXXXXXXX
XXXXXXXXXXXXXXXLXLLLLLLLLLLLLLLLLLXXXXXXXXXXXX
XXXXXXXXXXXXXXXLLLLLLLLLLLLLLLLLLLLXXXXXXXXXXX
XXXXXXXXXXXXXXXXLLLLLLLLXXXXXXXXXLLLXXXXXXXXXX
XXXXXXXXXXXXXXXXXXXXXLLXXXXXXXXXXXLLLXXXXXXXXX
XXXXXXXXXXXXXXXXXXXXXLLXXXXXXXXXXXXLLLXXXXXXXX
XXXXXXXXLXLXXXXXXXXXXLLXXXXXXXXXXXXLLLXXXXXXXX
XXLLXLLLLLLXXXXXXXXXXLLXXXXXXXXXXXXLLLXXXXXXXX
XXLLLLLLLLLXXXXXXXXXLLLLXXXXXXXXXXXLLLXXXXXXXX
XXLLLLXXLLLXXXXXXXXLLLLLLLLXXXXXXXXLLLXXXXXXXX
XXXXXXXXLLLXXXXXXXXLLLLLLLLXXXXXXXXLLLXXLXXLXX
XXXXXXXXLLLXXXXXXXXXLLLLLLXXXXXXXXXLLLLLLLLLXX
XXXXXXXXLLLXXXXXXXXXXXXLLXXXXXXXXXXLLLLLLLLLXX
XXXXXXXXLLLXXXXXXXXXXXXLLXXXXXXXXXXLLLXXLLLLXX
XXXXXXXXLLLXXXXXXXXXXXXLLXXXXXXXXXXXXXXXXXXXXX
XXXXXXXXXLLLXXXXXXXXXXXLLXXXXXXXXXXXXXXXXXXXXX
XXXXXXXXXXLLLXXXXXXXXXLLLLLLLLXXXXXXXXXXXXXXXX
XXXXXXXXXXXLLLLLLLLLLLLLLLLLLLLXXXXXXXXXXXXXXX
XXXXXXXXXXXXLLLLLLLLLLLLLLLLXLLXXXXXXXXXXXXXXX
XXXXXXXXXXXXXXXXXXXXXXLLLLLLLLXXXXXXXXXXXXXXXX
XXXXXXXXXXXXXXXXXXXXXXXXXXXXXXXXXXXXXXXXXXXXXX
XXXXXXXXXXXXXXXXXXXXXXXXXXXXXXXXXXXXXXXXXXXXXX