0000000000000000000000000000000000000000000000
0000000000000000000000000000000000000000000000
000000000000000XXXXXXXX00000000000000000000000
00000000000000XX1XXXXXXXXXXXXXX000000000000000
00000000000000XXXXXXXXXXXXXXXXXXX0000000000000
000000000000000XXXXXXXX0000000XXXXX00000000000
000000000000000000000XX000000000XXXXX000000000
000000000000000000000XX00000000000XXX000000000
00XXXX00X4X0000000000XX000000000000XXX00000000
00XXXXXXXXX0000000000XX000000000000XXX00000000
00XXXXXXXXX000000003XXXXXX300000000XXX00000000
00XXXX00XXX00000000XXXXXXXX00000000XXX00000000
00000000XXX00000000XXXXXXXX00000000XXX00XXXX00
00000000XXX000000003XXXXXX300000000XXXXXXXXX00
00000000XXX000000000000XX0000000000XXXXXXXXX00
00000000XXX000000000000XX0000000000XXX00XXXX00
00000000XXXXX0000000000XX000000000000000000000
000000000XXXX0000000000XX000000000000000000000
0000000000XXXX00000000XXXXXXXX0000000000000000
000000000000XXXXXXXXXXXXXXXXXXX000000000000000
00000000000000XXXXXXXXXXXXXX1XX000000000000000
0000000000000000000000XXXXXXXX0000000000000000
0000000000000000000000000000000000000000000000
0000000000000000000000000000000000000000000000