0000000000000000000000000000000000000000000000
0000000000000000000000000000000000000000000000
000000000000000XXX4XXXX00000000000000000000000
00000000000000XXXXXXXXXXXXXXXXX000000000000000
00000000000000XXXXXXXXXXXXXXXXXXX0000000000000
000000000000000XXXXXXXX0000000XXXXX00000000000
000000000000000000000XX000000000XXXXX000000000
000000000000000000000XX00000000000XXX000000000
00XXXX00XXX0000000000XX000000000000XXX00000000
003XXXXXXXX0000000000XX000000000000XXX00000000
00XXXXXXXXX00000000XXXXXXXX00000000XXX00000000
00XXXX00XXX00000000XXXXXXXX00000000XXX00000000
00000000XXX00000000XXXXXXXX00000000XXX00XXXX00
00000000XXX00000000XXXXXXXX00000000XXXXXXXXX00
00000000XXX000000000000XX0000000000XXXXXXXX500
00000000XXX000000000000XX0000000000XXX00XXXX00
00000000XXXXX0000000000XX000000000000000000000
000000000XXXX0000000000XX000000000000000000000
0000000000XXXX00000000XXXXXXXX0000000000000000
000000000000XXXXXXXXXXXXXXXXXXX000000000000000
00000000000000XXXXXXXXXXXXXXXXX000000000000000
0000000000000000000000XXXXX1XX0000000000000000
0000000000000000000000000000000000000000000000
0000000000000000000000000000000000000000000000