0000000000000000000000000000000000000000000000
0000000000000000000000000000000000000000000000
000000000000000XXXXXXXX00000000000000000000000
00000000000000XXXXXXXXXXXXXXXXX000000000000000
00000000000000XXXX2XXXXXX1XXXXXXX0000000000000
000000000000000XXXXXXXX0000000XXX4X00000000000
000000000000000000000XX000000000XXXXX000000000
000000000000000000000X200000000000XXX000000000
00XXXX00XXX0000000000XX000000000000XXX00000000
00XXXXXXXXX0000000000XX000000000000XXX00000000
004X1XXXXXX00000000XXXX4XXX00000000XX100000000
00XXXX00XXX00000000X1XXXXXX00000000XXX00000000
00000000XXX00000000XXXXX4XX00000000XXX00XXXX00
00000000XXX00000000XXXXXXXX00000000X2XXXXXXX00
00000000XXX000000000000XX0000000000XXXXXXXXX00
00000000XXX000000000000XX0000000000XXX003XXX00
00000000XXXXX0000000000XX000000000000000000000
000000000XXXX0000000000X2000000000000000000000
0000000000XXXX00000000XXXXXXXX0000000000000000
000000000000XXXXXXXXXXXXXXXXXXX000000000000000
00000000000000XXX1XXXXXXX1XXXXX000000000000000
0000000000000000000000XXXXXXXX0000000000000000
0000000000000000000000000000000000000000000000
0000000000000000000000000000000000000000000000