0000000000000000000000000000000000000000000000
0000000000000000000000000000000000000000000000
000000000000000XXXXXXXX00000000000000000000000
00000000000000XXXXXXXXXXXXXXXXX000000000000000
00000000000000XXXXXXXXXXXXXXXXXXX0000000000000
000000000000000XXXXXXXX0000000XXXXX00000000000
000000000000000000000XX000000000XXXXX000000000
000000000000000000000XX00000000000XXX000000000
00122300XXX0000000000XX000000000000XXX00000000
00XX4XXXXXX0000000000XX000000000000XXX00000000
00XXXXXXXXX00000000XXXXX22X00000000XXX00000000
00XXXX00XXX00000000XXXXXXXX00000000XXX00000000
00000000XXX00000000XXXXXXXX00000000XXX00X13X00
00000000XXX00000000XXXXXXXX00000000XXXXXXXXX00
00000000XXX000000000000XX0000000000XXXXXXXXX00
00000000XXX000000000000XX0000000000XXX00XXXX00
00000000XXXXX0000000000XX000000000000000000000
000000000XXXX0000000000XX000000000000000000000
0000000000XXXX00000000XXXXXXXX0000000000000000
000000000000XXXXXXXXXXXXXXXXXXX000000000000000
00000000000000XXXXXXXXXXXXXXXXX000000000000000
0000000000000000000000XXXXXXXX0000000000000000
0000000000000000000000000000000000000000000000
0000000000000000000000000000000000000000000000