0000000000000000000000000000000000000000000000
0000000000000000000000000000000000000000000000
0000000000000000B44444450000000000000000000000
000000000000000B111111114444444445000000000000
000000000000000F11111111CCCCCCCCC1500000000000
0000000000000000FCCCC11D000000000F150000000000
000000000000000000000G200000000000F15000000000
000000000000000000000G2000000000000G1500000000
00B44500B450000000000G2000000000000G1200000000
00G111441120000000000G2000000000000G1200000000
00G111CC11200000000B411444500000000G1200000000
00FCCD00G1200000000G111111200000000G1200000000
00000000G1200000000G111111200000000G1200B44500
00000000G1200000000FCCC11CD00000000G1144111200
00000000G12000000000000G20000000000G11CC111200
00000000G12000000000000G20000000000FCD00FCCD00
00000000F12000000000000G2000000000000000000000
000000000F1500000000000G2000000000000000000000
0000000000F15000000000B11444450000000000000000
00000000000F1444444444111111115000000000000000
000000000000FCCCCCCCCC11111111D000000000000000
0000000000000000000000FCCCCCCD0000000000000000
0000000000000000000000000000000000000000000000
0000000000000000000000000000000000000000000000