XXXXXXXXXXXXXXXXXXXXXXXXXXXXXXXX
XXXXXXXXXXXXXXXXXXXXXXXXXXXXXXXX
XXXXXXXXXXXXXXXXXXXXXXXXXXXXXXXX
XXXXXXXXXXXXXXXXXXXXXXXXXXXXXXXX
XXXXXXXXXXXXXXXXXXXXXXXXXXXXXXXX
XXXLLLXXXXXLLLLLXLLLLLXXXXXXXXXX
XXXLLLLLLLLLLLLLLLLLLLLXXXXXXXXX
XXXLLLLXLLLLLLLLLLLLLLLLXXXXXXXX
XXXLLLLXXLLLLLLLLLLLLLLLLLXXXXXX
XXXXXXXXLLLLLLLLLLLLLLLXLLLXXXXX
XXXXXXXLLLLLLLLLLLLLLLLLLLLXXXXX
XXXXXLLLLXLLLLLLLLLLLLLLLLLXXXXX
XXXXXLLLLLLLLLLLLLLLLLLLLLXXXXXX
XXXXXXLLLLLLLLLLLLLXLLLXXXXXXXXX
XXXXXXXXLLLLLLLLLLLXXXXXXXXXXXXX
XXXXXLLLLLLLLLLLLLLXXXXXXXXXXXXX
XXXXLLLLLLLLLLLLLLLLXXXXXXXXXXXX
XXXLLLLLLLLLXLLLLLLLLLLLXXXXXXXX
XXLLLLLLXXXXXXXXXXXLLLLLLLXXXXXX
XXLLLLLLXXXXXXXXXXXXLLLLLLLLXXXX
XXLXLLLLLXXXXXXXXXXXXLLLLLLLLXXX
XXXLLLLLLXXXXXXXXXXXXXXLLLLLLXXX
XXXXLLLLLLXXXXXXXXXXXXXXLLLLLLXX
XXXXXLLLLLXXXXXXXXXXXXLLLLLLXXXX
XXXXXXLLLLXXXXXXXXXXLLLLLLLLLXXX
XXXXXXXXLLLLLLLLLLLLLLLLLLLXXXXX
XXXXXXXXXXLLLLLLLLLLLLLLXXXXXXXX
XXXXXXXXXXXLLLLLLLLLLLXXXXXXXXXX
XXXXXXXXXXXXLLLLXLLLXXXXXXXXXXXX
XXXXXXXXXXXXXXLLLXXXXXXXXXXXXXXX
XXXXXXXXXXXXXXXXXXXXXXXXXXXXXXXX
XXXXXXXXXXXXXXXXXXXXXXXXXXXXXXXX