00000000000000000000000000000000
00000000000000000000000000000000
00000000000000000000000000000000
00000000000000000000000000000000
00000000000000000000000000000000
000XXXX0000XXXXXXXXXXX0000000000
000X4XXXXXXXXXXXXXXXXXX000000000
000XXXXXXXXXXXXXXXXXXXXX00000000
000XXXX00XXXXXXXXXXXXXXXXX000000
00000000XXXXXXXXXXXX3XXXXXX00000
0000000XXXXXXXXXXXXXXXXXXXX00000
00000XXXXXXXXXXXXXXXXXXXXXX00000
00000XXXXX3XXXXXXXXXXXX1XX000000
000000XXXXXXXXXXXXXXXXX000000000
00000000XXXXXXXXXXX0000000000000
00000XXXXXXXX1XXXXX0000000000000
0000XXXXXXXXXXXXXXXXX00000000000
000XXX3XXXXXXXXXXXXXXXXX00000000
00XXXXXX00000000000XXXXXX1000000
00XXXXXXX00000000000XXXXXXXX0000
00XX3XXXX00000000000XXXXXXXXX000
000XXXXXX00000000000000XXXXXX000
0000XXXXXX00000000000000XXXXXX00
00000XXXXX00000000000XXXXXXX0000
000000XXXXX000000000XXXXX3XXX000
00000000XXXXXXXXX3XXXXXXXXX00000
0000000000XXXXXXXXXXXXXX00000000
00000000000XX3XXXXXXXX0000000000
000000000000XXXXXXXX000000000000
0000000000000XXXX000000000000000
00000000000000000000000000000000
00000000000000000000000000000000