00000000000000000000000000000000
00000000000000000000000000000000
00000000000000000000000000000000
00000000000000000000000000000000
00000000000000000000000000000000
000XXXX0000XXXXX3XXXXX0000000000
000XXXXXXXXXXXXXXXXXXXX000000000
000XXXX1XXXXXXXXXXXXXXXX00000000
000XXXX00XXXXXXXXXXXXXXXXX000000
00000000XXXXXXXXXXXXXXXXXXX00000
0000000XXXXXXXXXXXXXXXX3XXX00000
00000XXXX3XXXXXXXXXXXXXXXXX00000
00000XXXXXXXXXXXXXXXXXXXXX000000
000000XXXXXXXXXXXXX3XXX000000000
00000000XXXXXXXXXXX0000000000000
00000XXXXXXXXXXXXXX0000000000000
0000XXXXXXXXXXXXXXXXX00000000000
000XXXXXXXXX3XXXXXXXXXXX00000000
00XXXXXX00000000000XXXXXXX000000
00XXXXXX300000000000XXXXXXXX0000
00X1XXXXX000000000003XXXXXXXX000
000XXXXXX00000000000000XXXXXX000
0000XXXXXX00000000000000XXXXXX00
00000XXXXX000000000003XXXXXX0000
000000XXXX3000000000XXXXXXXXX000
00000000XXXXXXXXXXXXXXXXXXX00000
0000000000XXXXXXXXXXXXXX00000000
00000000000XXXXXXXXXXX0000000000
000000000000XXX1XXXX000000000000
0000000000000XXXX000000000000000
00000000000000000000000000000000
00000000000000000000000000000000