00000000000000000000000000000000
00000000000000000000000000000000
00000000000000000000000000000000
00000000000000000000000000000000
00000000000000000000000000000000
000XXX30000XXXXXXXXXXX0000000000
000XXXXXXXXXXXXXXXXXXXX000000000
000XXXXXXXXXXXXXXXXXXXXX00000000
000XXXX00XXXXXXXXXXXXXXXXX000000
00000000XXXXXXXXXXXXXXXXXXX00000
0000000XXXXXXXXXXXXXXXXXXXX00000
00000XXXXXXXXXXXXXXXXXXXXXX00000
00000XXXXXXXXXXXXXXXXXXXXX000000
000000XXXXXXXXXXXXXXXXX000000000
00000000XXXXXXXXXXX0000000000000
00000XXXXXXXXXXXXXX0000000000000
0000XXXXXXXXXXXXXXXX300000000000
000XXXXXXXXXXXXXXXXXXXXX00000000
00XXXXXX00000000000XXXXXXX000000
00XXXXXXX00000000000XXXXXXXX0000
00XXXXXXX00000000000XXXXXXXXX000
000XXXXXX00000000000000XXXXXX000
0000XXXXXX00000000000000XXXXXX00
00000XXXXX00000000000XXXXXXX0000
000000XXXXX000000000XXXXXXXXX000
00000000XXXXXXXXXXXXXXXXXXX00000
0000000000XXXXXXXXXXXXXX00000000
00000000000XXXXXXXXXXX0000000000
000000000000XXXXXXXX000000000000
00000000000001XXX000000000000000
00000000000000000000000000000000
00000000000000000000000000000000