00000000000000000000000000000000
00000000000000000000000000000000
00000000000000000000000000000000
00000000000000000000000000000000
00000000000000000000000000000000
000XXXX0000XXXXXXXXXX30000000000
000X4XX1XXXXX3XXXXXXXXX000000000
000XXXXXXX1XXXXXXXXXXXX300000000
000X2XX00XXXXXXXXXXXXXXXXX000000
00000000X2XXXXXXXXXXX1XX4XX00000
0000000XXXXXXXXXXXXXXXXXXXX00000
00000XXXXX4XXXXXXXXXX4XX2XX00000
00000XXX2XXXXXXXXXXXXXXXXX000000
000000XXXXXXXXXXXXX4XXX000000000
00000000XXXX2XXX4XX0000000000000
00000XXXX3X4XXXXXXX0000000000000
0000XXXXXXXXXXXX1XXXX00000000000
000XX1XXXXX2XXX4XXXXXXXX00000000
00X3XXXX00000000000XX4XXXX000000
00XXXXXXX00000000000XXXXXXXX0000
00XX1XX4X00000000000XXXX1XX4X000
000XXXXXX00000000000000XXXXXX000
0000XX3XXX00000000000000XX3XXX00
00000XXXXX00000000000XXXXXXX0000
000000X1XXX000000000XX3XXXXXX000
00000000XXXXXXXX4XXXXXXX1XX00000
0000000000XXX2XXXXXX2XXX00000000
00000000000XXXXXX1XXXX0000000000
000000000000XX2XXXXX000000000000
0000000000000XXXX000000000000000
00000000000000000000000000000000
00000000000000000000000000000000