00000000000000000000000000000000
00000000000000000000000000000000
00000000000000000000000000000000
00000000000000000000000000000000
00000000000000000000000000000000
000B4450000B44444444450000000000
000G1114444111111111115000000000
000G111CC11111111111111500000000
000FCCD00G1111111111111145000000
00000000B11111111111111111500000
0000000B111111111111111111200000
00000B41111111111111111111D00000
00000F11111111111111111CCD000000
000000FC11111111111CCCD000000000
00000000G11111111120000000000000
00000B44111111111120000000000000
0000B111111111111114500000000000
000B1111CCCCCCCCCCC1144500000000
00B1111200000000000F111145000000
00G11111500000000000G11111450000
00F11111200000000000FCC111115000
000F1111200000000000000F11112000
0000F1111500000000000000G111C800
00000F111200000000000B4411120000
000000FC115000000000B111111C8000
00000000FC14444444441111CCD00000
0000000000F11111111111CD00000000
00000000000F11111111CD0000000000
000000000000F1111CCD000000000000
0000000000000FCCD000000000000000
00000000000000000000000000000000
00000000000000000000000000000000