XXXXXXXXXXXXXXXXXXXXXXXXXXXXXXXXXXXX
XXXXXXXXXXXXXXXXXXXXXXXXXXXXXXXXXXXX
XXXXXXXXXXXXXXXXXXXXXXXXXXXXXXXXXXXX
XXXXXXXXXXXXLLLLLLLLLLLLXXXXXXXXXXXX
XXXXXXXXLLLLLLLLLLLLLLLLLLLLXXXXXXXX
XXLLLLLLLLLLLLLLLLLLLLLLLLLLLLLLLLXX
XXLLLXXLLLLLLLLLLLLLLLLLLLLLLXXLLLXX
XXLLLXXLLLLLLLLLLLLLLLLLLLLLLXXLLLXX
XXLLLXXLLLLLLLLLLLLLLLLLLLLLLXXLLLXX
XXLLLXXLLLLLLLLLLLLLLLLLLLLLLXXLLLXX
XXLLLXLLLLLLLLLLLLLLLLLLLLLLLLXLLLXX
XXXLLLLLLLLLLLLLLLLLLLLLLLLLLLLLXXXX
XXXXXXXXXXLLLXXXLLLLXXXLLLXXXXXXXXXX
XXXXXXXXXXLLLLLLLLLLLLLLLLXXXXXXXXXX
XXXXXXXXXXLLLXXXLLLLXXXLLLXXXXXXXXXX
XXXXXXXXXXXLLLLLLLLLLLLLLLXXXXXXXXXX
XXXXXXXXXXLLLXLLLLLLLLXLLLXXXXXXXXXX
XXXXXXXXXXLLLXXXLLLLXXXLLLXXXXXXXXXX
XXXXXXXXXXLLLLLLLLLLLLLLLLXXXXXXXXXX
XXXXXXXXXXLLLXLLLLLLLLXLLLXXXXXXXXXX
XXXXXXXXXXLLLXXXLLLLXXXLLLXXXXXXXXXX
XXXXXXXXXXLLLLLLLLLLLLLLLLXXXXXXXXXX
XXXXXXXXXXLLLXLLLLLLLLXLLLXXXXXXXXXX
XXXXXXXXXXLLLXLLLLLLLLXLLLLXXXXXXXXX
XXXXXXXXLLLLLLLLLLLLLLLLLLLLXXXXXXXX
XXXXXXXXXLLLLXLLLLLLLLXLLLLLXXXXXXXX
XXXXXXXXXXXXXXXXXXXXXXXXXXXXXXXXXXXX
XXXXXXXXXXXXXXXXXXXXXXXXXXXXXXXXXXXX