XXXXXXXXXXXXXXXXXXXXXXXXXXXXXXXXXXXX
XXXXXXXXXXXXXXXXXXXXXXXXXXXXXXXXXXXX
XXXXXXXXXXXXXXXXXXXXXXXXXXXXXXXXXXXX
XXXXXXXXXXXXLLLLLLLLLLLLXXXXXXXXXXXX
XXXXXXXXLLLLLLLLLLLLLLLLLLLLXXXXXXXX
XXLLLLLLLLLLLLLLLLLLLLLLLLLLLLLLLLXX
XXLLLXXLLLLLLLLLLLLLLLLLLLLLLXXLLLXX
XXLLLXXLLLLLLLLLLLLLLLLLLLLLLXXLLLXX
XXLLLXXLLLLLLLLLLLLLLLLLLLLLLXXLLLXX
XXLLLXXLLLLLLLLLLLLLLLLLLLLLLXXLLLXX
XXLLLXLLLLLLLLLLLLLLLLLLLLLLLLXLLLXX
XXXLLLLLLLLLLLLLLLLLLLLLLLLLLLLLXXXX
XXXXXXXXXXLLLXXXLLLLXXXLLLXXXXXXXXXX
XXXXXXXXXXLLLLLLLLLLLLLLLLXXXXXXXXXX
XXXXXXXXXXLLLXXXLLLLXXXLLLXXXXXXXXXX
XXXXXXXXXX1LLLLLLLLLLLLLLLXXXXXXXXXX
XXXXXXXXXXLLLLLLLLLLLLLLLLXXXXXXXXXX
XXXXXXXXXXLLLXXXLLLLXXXLLLXXXXXXXXXX
XXXXXXXXXXLLLLLLLLLLLLLLLLXXXXXXXXXX
XXXXXXXXXXLLLLLLLLLLLLLLLLXXXXXXXXXX
XXXXXXXXXXLLLXXXLLLLXXXLLLXXXXXXXXXX
XXXXXXXXXXLLLLLLLLLLLLLLLLXXXXXXXXXX
XXXXXXXXXXLLLLLLLLLLLLLLLLXXXXXXXXXX
XXXXXXXXXXLLLLXLLLLLLLLXLLLXXXXXXXXX
XXXXXXXXLLLLLLLLLLLLLLLLLLLLXXXXXXXX
XXXXXXXXXLLLLLLLLLLLLLLLLLLLXXXXXXXX
XXXXXXXXXXXXXXXXXXXXXXXXXXXXXXXXXXXX
XXXXXXXXXXXXXXXXXXXXXXXXXXXXXXXXXXXX