000000000000000000000000000000000000
000000000000000000000000000000000000
000000000000XXXXXXXXXXXX000000000000
00000000XXXXX1114XX4111XXXXX00000000
000XXXXXX111XX2XXXXX2XXX111XXXXXX000
00XXX22XXXXXXXXXXXXXXXXXXXXXX22XXX00
00XXX00XXXXXXXXXXXXXXXXXXXXXX00XXX00
00XXX00XXXXXXXXXXXXXXXXXXXXXX00XXX00
00XXX00XXXXXXXXXXXXXXXXXXXXXX00XXX00
00XXX00XXXXXXXXXXXXXXXXXXXXXX00XXX00
00XXXXXXXXXXXXXXXXXXXXXXXXXXXXXXXX00
000XXXXXXXXXXXXXXXXXXXXXXXXXXXXXX000
0000000000XXXXXXXXXXXXXXXX0000000000
0000000000XXXXXXXXXXXXXXXX0000000000
0000000000XXX0XXXXXXXX0XXX0000000000
0000000000XXXXXXX11XXXXXXX0000000000
0000000000XXXXXXX1XXXXXXXX0000000000
0000000000XXX0XX11XXXX0XXX0000000000
0000000000XXXXXXXXXXXXXXXX0000000000
0000000000XXXXXXXX11XXXXXX0000000000
0000000000XXX0XXXXXXXX0XXX0000000000
0000000000XXXXXXX1XXXXXXXX0000000000
0000000000XXXXXXX11XXXXXXX0000000000
00000000XXXXX0XXXXXXXX0XXXXX00000000
00000000XXXXXXXXXX111XXXXXXX00000000
00000000XXX11XXXXXX11XXXXXXX00000000
000000000000000000000000000000000000
000000000000000000000000000000000000