000000000000000000000000000000000000
000000000000000000000000000000000000
000000000000XXXXXXXXXXXX000000000000
00000000XXXXXXXXXXXXXXXXXXXX00000000
000XXXXXXXXXXXXXXXXXXXXXXXXXXXXXX000
00XXXXXXXXXXXXXXXXXXXXXXXXXXXXXXXX00
00XXX00XXXXXXXXXXXXXXXXXXXXXX00XXX00
00XXX00XXXXXXXXXXXXXXXXXXXXXX00XX600
00XXX00XXXXXXXXXXXXXXXXXXXXXX00XXX00
00XXX00XXXXXXXXXXXXXXXXXXXXXX00XXX00
00XXXXXXXXXXXXXXXXXXXXXXXXXXXXXXXX00
000XXXXXXXXXXXXXXXXXXXXXXXXXXXXXX000
0000000000XXXXXXXXXXXXXXXX0000000000
0000000000XXXXXXXXXXXXXXXX0000000000
0000000000XXX0XXXXXXXX0XXX0000000000
0000000000XXXXXXXXXXXXXXXX0000000000
0000000000XXXXXXXXXXXXXXXX0000000000
0000000000XXX0XXXXXXXX0XXX0000000000
0000000000XXXXXXXXXXXXXXXX0000000000
0000000000XXXXXXXXXXXXXXXX0000000000
0000000000XXX0XXXXXXXX0XXX0000000000
0000000000XXXXXXXXXXXXXXXX0000000000
0000000000XXXXXXXXXXXXXXXX0000000000
00000000XXXXX0XXXXXXXX0XXXXX00000000
00000000XXXXXXXXXXXXXXXXXXXX00000000
00000000XXXXXXXXXX2XXXXXXXXX00000000
000000000000000000000000000000000000
000000000000000000000000000000000000