000000000000000000000000000000000000
000000000000000000000000000000000000
000000000000222222222222000000000000
000000002222XXXXXXXXXXXX222200000000
00022222XXXXXXXXXXXXXXXXXXXX22222000
00XXXXXXXXXXXXXXXXXXXXXXXXXXXXXXXX00
00XXX00XXXXXXXXXXXXXXXXXXXXXX00XXX00
00XXX00XXXXXXXXXXXXXXXXXXXXXX00XXX00
00XXX00XXXXXXXXXXXXXXXXXXXXXX00XXX00
00XXX00XXXXXXXXXXXXXXXXXXXXXX00XXX00
00XXXXXXXXXXXXXXXXXXXXXXXXXXXXXXXX00
000XXXXXXXXXXXXXXXXXXXXXXXXXXXXX3000
0000000000XXX444XXXX444XXX0000000000
0000000000XXXXXXXXXXXXXXXX0000000000
0000000000XXX044XXXX440XXX0000000000
00000000001XXXXXXXXXXXXXXX0000000000
0000000000XXXXXXXXXXXXXXXX0000000000
0000000000XXX044XXXX440XXX0000000000
0000000000XXXXXXXXXXXXXXXX0000000000
0000000000XXXXXXXXXXXXXXXX0000000000
0000000000XXX044XXXX440XXX0000000000
0000000000XXXXXXXXXXXXXXXX0000000000
0000000000XXXXXXXXXXXXXXXX0000000000
0000000033XXXX0XXXXXXXX0XXX100000000
00000000XXXXXXXXXXXXXXXXXXXX00000000
000000001XXXXXXXXXXXXXXXXXXX00000000
000000000000000000000000000000000000
000000000000000000000000000000000000