000000000000000000000000000000000000
000000000000000000000000000000000000
000000000000XXXXXXXXXXXX000000000000
00000000XXXXX4XXXXXXXXXXXXXX00000000
000XXXXXXXXXXXXXXXXXXXXX4XXXXXXXX000
00XXXXXX2XXXXX3XXXXXXXXXXXXXXXX2XX00
00XXX00XXXX4XXXXXXXXXX1XXXXXX00XXX00
00XXX00XXXXXXXXXXXXXXXXXXX2XX00XXX00
00X2X00XXXXXX4XXXXXXX4XXXXXXX00X1X00
00XXX00XX3XXXXXXXXXXXXXXXXXXX00XXX00
00XXXXXXXXXXXXXXXXXXXXXX2XXXXXXXXX00
000XXXX1XXXXXXXXXXXXXXXXXXXXXXXXX000
0000000000XXXXXXX3XXXXXXXX0000000000
0000000000XXXXXXXXXXXXXXXX0000000000
0000000000XXX0XXXXXXXX0XXX0000000000
0000000000XXXXXXXXXXXX4XXX0000000000
0000000000X3XXXXXXXXXXXXXX0000000000
0000000000XXX0XXXXXXXX0XXX0000000000
0000000000XXXXXXXXXXXXXXXX0000000000
0000000000XXXXX2XXXX4XXXXX0000000000
0000000000XXX0XXXXXXXX0XXX0000000000
0000000000XXXXXXXXXXXXXX2X0000000000
0000000000X1XXXXXXXX3XXXXX0000000000
00000000XXXXX0XXXXXXXX0XXXXX00000000
00000000XXXXXXXX4XXXXXXXXXXX00000000
00000000XXXXXXXXXXXXXXXXXXXX00000000
000000000000000000000000000000000000
000000000000000000000000000000000000