000000000000000000000000000000000000
000000000000000000000000000000000000
000000000000B44444444445000000000000
00000000B444111111111111444500000000
000B44441111111111111111111144445000
00B11CC1111111111111111111111CC11500
00G1200G11111111111111111111200G1200
00G1200G11111111111111111111200G1200
00G1200G11111111111111111111200G1200
00G1200G11111111111111111111200G1200
00F114411111111111111111111114411D00
000FCCCCCC1111111111111111CCCCCCD000
0000000000G1111111111111120000000000
0000000000G11C11111111C1120000000000
0000000000G120G11111120G120000000000
0000000000G1141111111141120000000000
0000000000G11C11111111C1120000000000
0000000000G120G11111120G120000000000
0000000000G1141111111141120000000000
0000000000G11C11111111C1120000000000
0000000000G120G11111120G120000000000
0000000000G1141111111141120000000000
0000000000G11C11111111C1120000000000
00000000B41120G11111120G114500000000
00000000G111141111111141111200000000
00000000FCCCCCCCCCCCCCCCCCCD00000000
000000000000000000000000000000000000
000000000000000000000000000000000000