XXXXXXXXXXXXXXXXXXXXXXXXXXXXXXXXXXX
XXXXXXXXXXXXXXXXXXXXXXXXXXXXXXXXXXX
XXXXXXXXXXXXXXXXXLXXXXXXXXXXXXXXXXX
XXXXXXXXXXXXXXLLLLLLLXXXXXXXXXXXXXX
XXXXXXXXXXXXXLLLLLLLLLXXXXXXXXXXXXX
XXXXXXXXXXXXXLLLLLLLLLXXXXXXXXXXXXX
XXXXXXXXXXXXLLLLLLLLLLLXXXXXXXXXXXX
XXXXXXXXXXXXLLLLLLLLLLLXXXXXXXXXXXX
XXXXXXXXXXXXXXLXXXXXLXXXXXXXXXXXXXX
XXXXLLLLLLLLLLLXXXXXLLLLLLLLLLLXXXX
XXXXLXXXXXXXXXXXXXXXXXXXXXXXXXLXXXX
XXXXLXXXXXXXXXXXXXXXXXXXXXXXXXLXXXX
XXXXLXXXXXXXXXXXLLLXXXXXXXXXXXLXXXX
XXXXLXXXXXXXXXXXLLLXXXXXXXXXXXLXXXX
XXXXLXXXXXXXXLLLLLLLLLXXXXXXXXLXXXX
XXXXLXXXXXXXXLLLLLLLLLXXXXXXXXLXXXX
XXXLLLXXXXXXLLLLLLLLLLLXXXXXXLLLXXX
XXLXLLLLLLLLLLLLLLLLLLLLLLLLLLLXLXX
XXXLLLXXXXXXLLLLLLLLLLLXXXXXXLLLXXX
XXXXLXXXXXXXXLLLLLLLLLXXXXXXXXLXXXX
XXXXXXXXXXXXXLLLLLLLLLXXXXXXXXXXXXX
XXXXXXXXXXXXXXLLLLLLLXXXXXXXXXXXXXX
XXXXXXXXXXXXXXXLLLXXXXXXXXXXXXXXXXX
XXXXXXXXXXXXXXXXXLXXXXXXXXXXXXXXXXX
XXXXXXXXXXXXXXXXXLXXXXXXXXXXXXXXXXX
XXXXXXXXXXXXXXXXXLXXXXXXXXXXXXXXXXX
XXXXXXXXXXXXXXXXXLXXXXXXXXXXXXXXXXX
XXXXXXXXXXXXXXXXLLLXXXXXXXXXXXXXXXX
XXXXXXXXXXXXXXLLLLLLLXXXXXXXXXXXXXX
XXXXXXXXXXXXXLLLLLLLLLXXXXXXXXXXXXX
XXXXXXXXXXXXXLLLLLLLLLXXXXXXXXXXXXX
XXXXXXXLXXXXLLLLLLLLLLLXXXXLLXXXXXX
XXXXLLLLLLLLLLLLLLLLLLLLLLLLLLLXXXX
XXXXXLLLXXXXLLLLLLLLLLLXXXXLLLXXXXX
XXXXXXLXXXXXXLLLLLLLLLXXXXXXLXXXXXX
XXXXXXXXXXXXXLLLLLLLLLXXXXXXXXXXXXX
XXXXXXXXXXXXXXLLLLLLLXXXXXXXXXXXXXX
XXXXXXXXXXXXXXXXLLLXXXXXXXXXXXXXXXX
XXXXXXXXXXXXXXXXXXXXXXXXXXXXXXXXXXX
XXXXXXXXXXXXXXXXXXXXXXXXXXXXXXXXXXX