00000000000000000000000000000000000
00000000000000000000000000000000000
0000000000000000XXX0000000000000000
00000000000000XXXXXXX00000000000000
0000000000000XXXXXXXXX0000000000000
0000000000000XX2XXX2XX0000000000000
000000000000XXXXXXXXXXX000000000000
000000000000XX11XXXX11X000000000000
00000000000000X00000X00000000000000
0000XXXXXXXXXXX00000XXXXXXXXXXX0000
0000X0000000000000000000000000X0000
0000X0000000000000000000000000X0000
0000X00000000000XXX00000000000X0000
0000X000000000XXXXXXX000000000X0000
0000X00000000XXXXXXXXX00000000X0000
0000X00000000XX11XXXXX00000000X0000
000XXX000000XXXXX111XXX000000XXX000
00XXXXXXXXXXXXXX141XXXXXXXXXXXXXX00
000XXX000000XXX11XXXXXX000000XXX000
0000200000000XXXX11XXX0000000020000
0000000000000XXXXXXXXX0000000000000
00000000000000XXXXXXX00000000000000
0000000000000002XXX2000000000000000
00000000000000000X00000000000000000
00000000000000000X00000000000000000
00000000000000000X00000000000000000
00000000000000000X00000000000000000
0000000000000000XXX0000000000000000
00000000000000XXXXXXX00000000000000
0000000000000XXXXXXXXX0000000000000
000000X000000XXXXXXXXX000000X000000
00000XXX0000XXXXXXXXXXX0000XXX00000
0000XXXXXXXXXXXXX4XXXXXXXXXXXXX0000
00000XXX0000XXXXXXXXXXX0000XXX00000
000000X000000XXXXXXXXX000000X000000
0000000000000XXXXXXXXX0000000000000
00000000000000XXXXXXX00000000000000
0000000000000000XXX0000000000000000
00000000000000000000000000000000000
00000000000000000000000000000000000