00000000000000000000000000000000000
00000000000000000000000000000000000
0000000000000000XXX0000000000000000
00000000000000XXXXXXX00000000000000
0000000000000XXXXXXXXX0000000000000
0000000000000XXXXXXXXX0000000000000
000000000000XX2XXXXXXX3000000000000
000000000000XXXXXXXXXXX000000000000
00000000000000X00000X00000000000000
0000XXXXXXXXXXX00000XXXXXXXXXXX0000
0000X0000000000000000000000000X0000
000040000000000000000000000000X0000
0000X00000000000XXX00000000000X0000
0000X000000000XXXXXXX00000000020000
0000X00000000XXXXXXXXX00000000X0000
0000X00000000XX4XXX2XX00000000X0000
000XXX000000XXXXXXXXXXX000000XXX000
00XXXXXXXXXXXXXXXXXXXXXXXXXXXXXXX00
000XXX000000XXXXXXXX4XX000000XXX000
0000X00000000XX4XXXXXX00000000X0000
0000000000000XXXXXXXXX0000000000000
00000000000000XXXXXXX00000000000000
000000000000000XXXXX000000000000000
00000000000000000X00000000000000000
00000000000000000X00000000000000000
00000000000000000X00000000000000000
00000000000000000X00000000000000000
0000000000000000XXX0000000000000000
00000000000000XXXXXXX00000000000000
0000000000000XXXXXXXXX0000000000000
000000X000000XX2XXXXXX000000X000000
00000XXX0000XXXXXXXXXXX0000XXX00000
0000XXXXXXXXXXXXXXXXXXXXXXXXXXX0000
00000XXX0000XXXXXXXX1XX0000XXX00000
000000X000000XXXXXXXXX000000X000000
0000000000000XXXXXXXXX0000000000000
00000000000000XXXXXXX00000000000000
0000000000000000XXX0000000000000000
00000000000000000000000000000000000
00000000000000000000000000000000000