00000000000000000000000000000000000
00000000000000000600000000000000000
0000000000000000B150000000000000000
00090000000000B41114500000000090000
0000000000000B111111150000000000000
0000009000000G111111120000000000000
000000000000B1111111115000000000000
009000000000FC1CCCCC1CD000000000000
00000000000000300000300000000000000
0000B777777777D00000F77777777750000
00003000000000000000000000000030000
00003000000900000000009000000030000
0000300000000000B450000000000030000
00003000090000B41114500000900030000
0000300000000B111111150000000030000
0000300000000G111111120009000030000
000B15000000B1111111115000000B15000
00A11177777711111111111777777111800
000F1D000000F111111111D000000F1D000
0000E00000000G1111111200000000E0000
0000000000000F1111111D0000000000000
00009000000000F11111D00009000000000
000000000000000FC1CD000000000000000
00000000009000000300000000009000000
00000000000000000300000000000000000
00900000000000000300000000000000000
00000000000000000300000900000000000
0000000900000000B150000000000090000
00000000000000B41114500000000000000
0000000000000B111111150000000000000
0090006000000G111111120000006000000
00000B150000B11111111150000B1500000
0000A111777711111111111777711180000
00000F1D0000F111111111D0000F1D00000
000000E000000G11111112000000E000000
0000000000000F1111111D0000000000000
00000000000000FC111CD00000000000900
0000000000000000FCD0000000000000000
00000000000000000000000000000000000
00000000000000000000000000000000000