XXXXXXXXXXXXXXXXXXXXXXXXXXXXXXXXXXXX
XXXXXXXXXXXXXXXXXXXXXXXXXXXXXXXXXXXX
XXXXXXXXXXXXXXLLLLLLLLXXXXXXXXXXXXXX
XXXXLLLLLLLLLLLLLLLXLLLLLLLLLLXLXXXX
XXXXLLLLXLXLXLLLLLLLLLLXLXLXLLLLXXXX
XXXXLLLLXXXXXXLLLLLLLLXXXXXXLLLLXXXX
XXXXXLLXXXXXXXXXXXXXXXXXXXXXXLLXXXXX
XXXXXLLXXXXXXXXXXXXXXXXXXXXXXLLXXXXX
XXXXXLLXXXXXXLXXLLLLLLLXXXXXXLLXXXXX
XXXXXLLXXXXXLLLLLLLLLLLLXXXXXLLXXXXX
XXXXXLLXXXXXLLLXXLLXXLLLLXXXXLLXXXXX
XXXXXLLXXXLLLLXXXLLXXXLLLLXXXLLXXXXX
XXXXXLLXXXLLLXXXXLLXXXXLLLXXXLLXXXXX
XXXXXLLXXLLLLXXXXLLXXXXLLLLXXLLXXXXX
XXXXXLLXXLLLLXXXXLLXXXXLLLLLLLLXXXXX
XXXXXLLLLLLLLXXXLLLLXXXLLLLLLLXXXXXX
XXXXXXXXXLLLLXXXLLLLXXXLLLLXXXXXXXXX
XXXXXXXXXXLLLXXXLLLLXXXLLLXXXXXXXXXX
XXXXXXXXXXLLLLXXXXXXXXLLLLXXXXXXXXXX
XXXXXXXXXXXLLLLXXXXXXLLLLXXXXXXXXXXX
XXXXXXXXXXXLLLLLXLLXLLLLLXXXXXXXXXXX
XXXXXXXXXXXXLLLLLLLLLLLXXXXXXXXXXXXX
XXXXXXXXXXXXXXXXXLLXXXXXXXXXXXXXXXXX
XXXXXXXXXXXXXXXXXLLXXXXXXXXXXXXXXXXX
XXXXXXXXXXXXXXLLLLLLLLXXXXXXXXXXXXXX
XXXXXXXXXXXXXXLLLLLLLLXXXXXXXXXXXXXX
XXXXXXXXXXXXXXLLLLLLLLXXXXXXXXXXXXXX
XXXXXXXXXXXXXXLLLLLLLLXXXXXXXXXXXXXX
XXXXXXXXXXXXXXLLLLLLLLXXXXXXXXXXXXXX
XXXXXXXXXXXXXXXLLLLLLXXXXXXXXXXXXXXX
XXXXXXXXXXXXXXXXXXXXXXXXXXXXXXXXXXXX
XXXXXXXXXXXXXXXXXXXXXXXXXXXXXXXXXXXX