000000000000000000000000000000000000
000000000000000000000000000000000000
0000XXXX000000XXXXXXXX000000XXXX0000
0000XXXXXXXXXXXXXXXXXXXXXXXXXXXX0000
0000XXXXXXXXXXXXXXX11XXXXXXXXXXX0000
0000XXXX000000XXXXXXXX000000XXXX0000
00000XX0000000000000000000000XX00000
00000XX0000000000000000000000XX00000
00000X1000000XXXXXXXXXX000000X100000
00000XX00000XXXXXXXXXXXX00000XX00000
00000XX0000XXXX00XX00XXXX0000XX00000
00000XX000XXXX000XX000XXXX000XX00000
00000XX000XXXX000XX000XXXX000XX00000
00000XX00XXXX0000XX0000XXXX00XX00000
00000XXXX1XXX000XXXX000XXXXXXXX00000
00000XXXXXXXX000X4XX000XXXXXXXX00000
000000000XXXX000XXXX000XXXX000000000
0000000000XXXX002XX200XXXX0000000000
0000000000XX3X00000000XXXX0000000000
00000000000XXXX000000XXXX00000000000
00000000000XXXXXXXXXXXXXX00000000000
000000000000XXXXXXXXXXXX000000000000
00000000000000000XX00000000000000000
00000000000000000XX00000000000000000
00000000000000XXXXXXXX00000000000000
00000000000000XXXXXXXX00000000000000
00000000000000XXXXXXXX00000000000000
00000000000000XXXXXXXX00000000000000
00000000000000XXXXXXXX00000000000000
00000000000000XXXXXXXX00000000000000
00000000000000XXXXXXXX00000000000000
000000000000000XXXXXX000000000000000
000000000000000000000000000000000000
000000000000000000000000000000000000