000000000000000000000000000000000000
000000000000000000000000000000000000
0000XXXX000000XXXXXXXX000000XXXX0000
0000XXXXXXXXXXXXXXX1XXXXXXXXXXXX0000
0000XXXX2X2X2XXXXXXXXXX2X2X2XXXX0000
0000XXXX000000XXXXXXXX000000XXXX0000
00000XX0000000000000000000000XX00000
00000XX0000000000000000000000XX00000
00000XX000000XXXXXXXXXX000000XX00000
00000XX00000XXXXXXXXXXXX00000XX00000
00000XX0000XXXX00XX00XXXX0000XX00000
00000XX000XXXX000XX000XXXX000XX00000
00000XX000XXX3000XX0003XXX000XX00000
00000XX00XXXX0000XX0000XXXX00XX00000
00000XXXXXXXX000XXXX000XXXXXXXX00000
00000XXXXXXXX000XXXX000XXXXXXXX00000
000000000XXXX000XXXX000XXXX000000000
0000000000XXX300XXXX003XXX0000000000
0000000000XXXX00000000XXXX0000000000
00000000000XXXX000000XXXX00000000000
00000000000XXXXX4XX4XXXXX00000000000
000000000000XXXXXXXXXXX1000000000000
00000000000000000XX00000000000000000
00000000000000000XX00000000000000000
00000000000000XXXXXXXX00000000000000
00000000000000XXXXXXXX00000000000000
00000000000000XXXXXXXX00000000000000
00000000000000XXXXXXXX00000000000000
00000000000000XXXXXXXX00000000000000
00000000000000XXXXXXXX00000000000000
00000000000000XXXXXXXX00000000000000
000000000000000XXXXXX000000000000000
000000000000000000000000000000000000
000000000000000000000000000000000000