000000000000000000000000000000000000
000000000000000000000000000000000000
00003221000000XXXXXXXX00000022130000
0000XXXXXXXXXXXXXXXXXXXXXXXXXX4X0000
0000XXXXXXXXXXXXXXXXXXXXXXXXXXXX0000
0000XXXX000000XXXXXXXX000000XXXX0000
00000XX0000000000000000000000XX00000
00000XX0000000000000000000000XX00000
00000XX000000X33XXXXXXX000000XX00000
00000XX00000XXXXXXXXXXXX00000XX00000
00000XX00001XXX00XX00XXXX0000XX00000
00000XX000XXXX000XX000XXXX000XX00000
00000XX000XXXX000XX000XXXX000XX00000
00000XX00XXXX0000XX0000XXXX00XX00000
00000XX33XXXX0002XX2000XXXXXXXX00000
00000XXXXXXXX000XXXX000XXXXXXX100000
000000000XXXX000XXXX000XXXX000000000
0000000000XXXX00XXXX00XXXX0000000000
0000000000XXXX00000000XXXX0000000000
00000000000XXXX000000XXXX00000000000
00000000000XXXXXXXXXXXXXX00000000000
000000000000XXXXXXXXXXXX000000000000
00000000000000000XX00000000000000000
00000000000000000XX00000000000000000
00000000000000XXXXXXXX00000000000000
00000000000000XXXXXXXX00000000000000
00000000000000XXXXXXXX00000000000000
00000000000000XXXXXXXX00000000000000
00000000000000XXXXXXXX00000000000000
00000000000000XXXXXXXX00000000000000
00000000000000XXXXXXXX00000000000000
000000000000000XXXXXX000000000000000
000000000000000000000000000000000000
000000000000000000000000000000000000