000000000000000000000000000000000000
000000000000000000000000000000000000
0000XXXX000000XXXXXXXX000000XXXX0000
0000XXXXXXXXXXXX2XXXX4XXXXXXXXXX0000
0000X2XXX4XXXXXXXXXXXXXXXXXXXXXX0000
0000XXXX000000X3XXXX2X000000XXXX0000
00000XX00000000000000000000001X00000
00000XX0000000000000000000000XX00000
00000XX000000XXXXXXXXXX000000XX00000
00000XX00000XXXXX3XXX1XX00000XX00000
000001X0000XXX400XX00XXXX0000XX00000
00000XX000XX3X000XX000XXXX000XX00000
00000XX000XXXX000XX000X1XX000X100000
00000XX00XXXX0000XX0000XXXX00XX00000
00000XXXXXXXX000XXXX000XXX1XXX200000
00000XXXXXX2X000XXXX000XXXXX4XX00000
000000000XXXX000XXXX000X2XX000000000
0000000000XXXX00XXXX00XXXX0000000000
0000000000XXXX00000000XXXX0000000000
00000000000XXXX000000XX2X00000000000
00000000000XX4XXXXXXXXXXX00000000000
000000000000XXXX2XXXX2XX000000000000
00000000000000000XX00000000000000000
00000000000000000XX00000000000000000
00000000000000XXXXXXXX00000000000000
00000000000000XXXXXXXX00000000000000
00000000000000XXXXXXXX00000000000000
00000000000000XXXXXXXX00000000000000
00000000000000XXXXXXXX00000000000000
000000000000000XXXXXX000000000000000
000000000000000000000000000000000000
000000000000000000000000000000000000