000000000000000000000000000000000000
000000000000000000000000000000000000
0000B445000000B4444445000000B4450000
0000G1114444441111111144444411120000
0000G111CCCCCC11111111CCCCCC11120000
0000F11D000000FCCCCCCD000000F11D0000
00000G20000000000000000000000G200000
00000G20000000000000000000000G200000
00000G200000B4444444444500000G200000
00000G20000B111CC11CC11150000G200000
00000G20000G11D00G200F1120000G200000
00000G2000B112000G2000G115000G200000
00000G2000G11D000G2000F112000G200000
00000G200B1120000G20000G11500G200000
00000G1441112000B115000G111441200000
00000FCCC1112000G112000G111CCCD00000
000000000F112000G112000G11D000000000
0000000000G11500FCCD00B1120000000000
0000000000F11200000000G11D0000000000
00000000000G115000000B11200000000000
00000000000F111444444111D00000000000
000000000000FCCCC11CCCCD000000000000
00000000000000000G200000000000000000
00000000000000000G200000000000000000
00000000000000B441144500000000000000
00000000000000G111111200000000000000
00000000000000G111111200000000000000
00000000000000G111111200000000000000
00000000000000F111111D00000000000000
000000000000000FCCCCD000000000000000
000000000000000000000000000000000000
000000000000000000000000000000000000
000000000000000000000000000000000000
000000000000000000000000000000000000