XXXXXXXXXXXXXXXXXXXXXXXXXXXXXXXXXX
XXXXXXXXXXXXXXXXXXXXXXXXXXXXXXXXXX
XXXXXXXXXXXXXLLLLLLLLXXXXXXXXXXXXX
XXXXXXXXXXXXXLLLLLLLLXXXXXXXXXXXXX
XXXXLLXXXXXLLLLLLLLLLLLXXXXXXXXXXX
XXLLLLXXXXLLLLLLLLLLLLLLXXXXLXXLXX
XXLLLLLLLLLLLLLLLLLLLLLLLLLLLLLLXX
XXLLLLLLLLLLLLLLLLLLLLLLLLLLLLXLXX
XXLLXLXXXXLLLLLLLLLLLLLLXXXXLLLLXX
XXLLLLXXXXXLLLLLLLLLLLLXXXXXLLLLXX
XXXXXXXXXXXLLLLLLLLLLLLXXXXXXXXXXX
XXXXXXXXXXXXXLLLLLLLLXXXXXXXXXXXXX
XXXXXXXXXXXXXZLLLLLLXXXXXXXXXXXXXX
XXXXXXXXXXXXXXXXLLXXXXXXXXXXXXXXXX
XXXXXXXXLXXXXXXXLLXXXXXXXLXLXXXXXX
XXXXXXLLLLLLXXXXLLXXXXLLLLLLXXXXXX
XXXXXXLLLXXLXXXXLLXXXXLXXLLLXXXXXX
XXXXXXXXXXXLLLLLLLLLLLLXXXXXXXXXXX
XXXXXXLLLXXXXXXLLLLXXXXXXLLLXXXXXX
XXXXXXLLLLLLLLLLLLLLLLLLLLLLXXXXXX
XXXXXXLLLXXXXXXLLLLXXXXXXLLLXXXXXX
XXXXXXXXXXXLLLLLLLLLLLLXXXXXXXXXXX
XXXXXXLLLXXLXXXLLLLXXXLXXLLXXXXXXX
XXXXXXLLLLLLXXXXLLXXXXLLLLLLXXXXXX
XXXXXXLXLXXXXXXXLLXXXXXXXLXLXXXXXX
XXXXXXXXXXXXXXXLLLLXXXXXXXXXXXXXXX
XXXXXXXXXXXXXXXXXXXXXXXXXXXXXXXXXX
XXXXXXXXXXXXXXXXXXXXXXXXXXXXXXXXXX