0000000000000000000000000000000000
0000000000000000000000000000000000
0000000000000XXXXXXXX0000000000000
00000000000XXXXXXXXXXXX00000000000
00XXXX00000XXXXXXXXXXXX00000XXXX00
00XXXX0000XXXXXXXXXXXXXX0000XXXX00
00XXXXXXXXXXXXXXXXXXXXXXXXXXXXXX00
00XXXXXXXXXXXXXXXXXXXXXXXXXXXXXX00
00XXXX0000XXXXXXXXXXXXXX0000XXXX00
00XXXX00000XXXXXXXXXXXX00000XXXX00
00000000000XXXXXXXXXXXX00000000000
0000000000000XXXXXXXX0000000000000
0000000000000XXXXXXXX0000000000000
0000000000000000XX0000000000000000
000000XXX0000000XX0000000XXX000000
000000XXXXXX0000XX0000XXXXXX000000
000000XXX00X0000XX0000X00XXX000000
00000000000XXXXXXXXXXXX00000000000
000000XXX000000XXXX000000XXX000000
000000XXXXXXXXXXXXXXXXXXXXXX000000
000000XXX000000XXXX000000XXX000000
00000000000XXXXXXXXXXXX00000000000
000000XXX00X000XXXX000X00XXX000000
000000XXXXXX0000XX0000XXXXXX000000
000000XXX000000XXXX000000XXX000000
000000000000000XX2X000000000000000
0000000000000000000000000000000000
0000000000000000000000000000000000