0000000000000000000000000000000000
0000000000000000000000000000000000
0000000000000XXXXXXXX0000000000000
00000000000XXXXXXXXXXXX00000000000
00XXXX00000XXXXXXXX4XXX00000XXXX00
00XXXX0000XXXX4XXXXXXXXX0000XXXX00
00X2XXXXXXXXXXXXXXX2XXXXXXXXXXXX00
00XXXXXXXXXX2XXXXXXXXXXXXXXXXXXX00
00XXXX0000XXXXXX4XXXX1XX0000X1XX00
00XXXX00000XXXXXXXXX4XX00000XXXX00
00000000000XXX4XXXXXXXX00000000000
0000000000000XXXXXX4X0000000000000
0000000000000XX1XXXXX0000000000000
0000000000000000XX0000000000000000
000000XXX0000000XX0000000XXX000000
000000XXXXXX0000XX0000XXXXXX000000
000000XXX00X0000XX0000X00XX3000000
00000000000XX3XXXXXX4XX00000000000
000000XXX000000XXXX000000XXX000000
000000XXXXXXXXXXXXXXXXXXXX2X000000
000000XXX000000XXXX000000XXX000000
00000000000XXXXX4XXXXXX00000000000
000000XXX00X000XXXX000X00XXX000000
000000XXXXX40000XX0000XXXXXX000000
000000XXX000000XXXX000000XXX000000
000000000000000XXXX000000000000000
0000000000000000000000000000000000
0000000000000000000000000000000000