0000000000000000000000000000000000
0000000000000000000000000000000000
0000000000000B44444450000000000000
00000000000B4111111114500000000000
00B44500000G1111111111200000B44500
00G1120000B11111111111150000G11200
00G1114444111111111111114444111200
00G111CCCC11111111111111CCCC111200
00G1120000F111111111111D0000G11200
00FCCD00000G1111111111200000FCCD00
00000000000FC11111111CD00000000000
0000000000000G11111120000000000000
0000000000000FCC11CCD0000000000000
0000000000000000G20000000000000000
000000B450000000G20000000B45000000
000000G117750000G20000B77112000000
000000FCD0030000G20000300FCD000000
00000000000F7774114777D00000000000
000000B45000000G112000000B45000000
000000G117777771111777777112000000
000000FCD000000G112000000FCD000000
00000000000B7771111777500000000000
000000B45003000F11C000300B45000000
000000G1177D0000G20000F77112000000
000000FCD000000B115000000FCD000000
000000000000000FCCD000000000000000
0000000000000000000000000000000000
0000000000000000000000000000000000